.,.,R,.,.,G,.,.
.,Y,.,B,.,.,.,.
N,.,N,.,N,.,.,.
.,.,.,.,.,.,.,.
.,.,.,.,.,.,.,.
.,.,.,.,.,.,.,.
.,.,.,.,.,.,.,.
.,.,.,.,.,.,.,.
